0 0 0 0 0 0 0 0 0 0 0 0 0 0 0 0 0 0 0 0 0 0 0 0 0 0 0 0 0 0 0 0 0 0 0 0 0 0 0 0 0 0 0 0 0 0 0 0 0 0 
0 0 0 0 0 0 0 0 0 0 0 0 0 0 0 0 0 0 0 0 0 0 0 0 0 0 0 0 0 0 0 0 0 0 0 0 0 0 0 0 0 0 0 0 0 0 0 0 0 0 
0 0 0 0 0 0 0 0 0 0 0 0 0 0 0 0 0 0 0 0 0 0 0 0 0 0 0 0 0 0 0 0 0 0 0 0 0 0 0 0 0 0 0 0 0 0 0 0 0 0 
0 0 0 0 0 0 0 0 0 0 0 0 0 0 0 0 0 0 0 0 0 0 0 0 0 0 0 0 0 0 0 0 0 0 0 0 0 0 0 0 0 0 0 0 0 0 0 0 0 0 
0 0 0 0 0 0 0 0 0 0 0 0 0 0 0 0 0 0 0 0 0 0 0 0 0 0 0 0 0 0 0 0 0 0 0 0 0 0 0 0 0 0 0 0 0 0 0 0 0 0 
0 0 0 0 0 0 0 0 0 0 0 0 0 0 0 0 0 0 0 0 0 0 0 0 0 0 0 0 0 0 0 0 0 0 0 0 0 0 0 0 0 0 0 0 0 0 0 0 0 0 
0 0 0 0 0 0 0 38 38 38 38 38 38 38 38 38 38 38 38 38 38 38 38 38 38 38 38 38 38 38 38 38 38 38 38 38 38 38 38 38 38 38 38 0 0 0 0 0 0 0 
0 0 0 0 0 0 0 38 38 38 38 38 38 38 38 38 38 38 38 77 77 77 77 77 77 77 77 77 77 77 77 77 38 38 38 38 38 38 38 38 38 38 38 0 0 0 0 0 0 0 
0 0 0 0 0 0 0 38 38 38 38 38 38 38 38 38 38 38 38 77 77 77 77 77 79 79 79 77 77 77 77 77 38 38 38 38 38 38 38 38 38 38 38 0 0 0 0 0 0 0 
0 0 0 0 0 0 0 38 38 39 38 38 38 38 38 38 38 38 77 77 77 77 77 77 80 80 80 77 77 77 77 77 38 38 38 38 38 38 38 38 38 38 38 0 0 0 0 0 0 0 
0 0 0 0 0 0 0 38 38 38 38 38 38 38 38 38 38 77 77 77 77 77 77 77 87 80 87 77 77 77 77 77 38 38 39 38 38 38 38 38 38 39 38 0 0 0 0 0 0 0 
0 0 0 0 0 0 0 38 38 38 38 38 38 39 39 38 38 77 77 77 77 77 77 77 88 80 88 77 77 77 77 77 38 38 38 38 38 38 38 38 38 38 38 0 0 0 0 0 0 0 
0 0 0 0 0 0 0 38 38 38 38 38 38 38 38 38 77 77 77 77 77 77 77 77 77 80 77 77 77 77 77 77 77 38 38 38 38 38 38 38 38 38 38 0 0 0 0 0 0 0 
0 0 0 0 0 0 0 38 38 38 38 38 38 38 38 77 77 77 77 77 77 77 74 77 77 80 77 77 77 77 77 77 77 77 77 38 38 38 38 38 38 38 38 0 0 0 0 0 0 0 
0 0 0 0 0 0 0 38 38 39 38 38 38 38 77 77 77 77 77 77 77 77 77 77 77 80 77 77 77 77 77 77 77 77 77 77 77 38 38 38 39 38 38 0 0 0 0 0 0 0 
0 0 0 0 0 0 0 38 38 38 38 38 77 77 77 77 77 77 77 77 77 85 77 77 77 80 77 77 77 85 77 77 77 77 77 77 77 77 77 38 38 38 38 0 0 0 0 0 0 0 
0 0 0 0 0 0 0 38 38 38 38 77 77 77 77 77 77 77 77 77 79 86 79 80 87 80 87 80 79 86 77 77 77 77 77 77 77 77 77 38 38 38 38 0 0 0 0 0 0 0 
0 0 0 0 0 0 0 38 38 38 38 77 77 77 77 77 77 77 79 79 80 80 80 80 88 80 88 80 80 80 79 79 77 77 77 77 77 77 77 77 38 38 38 0 0 0 0 0 0 0 
0 0 0 0 0 0 0 38 38 38 38 77 77 77 77 77 77 79 80 75 80 80 80 80 80 80 80 80 80 80 80 80 79 79 77 77 77 77 77 77 38 38 38 0 0 0 0 0 0 0 
0 0 0 0 0 0 0 38 38 38 38 77 77 77 77 77 79 80 80 80 80 80 80 80 80 80 80 80 80 80 80 80 80 80 79 77 77 77 77 77 38 38 38 0 0 0 0 0 0 0 
0 0 0 0 0 0 0 38 38 38 38 77 77 77 77 79 80 80 80 80 52 53 53 55 80 80 80 80 80 75 80 80 80 80 80 77 77 77 77 77 77 38 38 0 0 0 0 0 0 0 
0 0 0 0 0 0 0 38 38 38 38 77 77 77 79 87 80 80 80 80 56 57 57 59 80 80 80 80 80 80 80 80 80 80 80 79 80 77 77 77 77 38 38 0 0 0 0 0 0 0 
0 0 0 0 0 0 0 38 38 38 38 77 77 77 80 88 80 80 80 80 60 61 62 63 80 80 80 80 80 80 80 80 80 80 87 80 80 77 77 77 77 38 38 0 0 0 0 0 0 0 
0 0 0 0 0 0 0 38 38 38 38 77 77 77 77 80 80 80 80 80 80 80 80 80 80 80 80 80 80 80 80 80 80 80 88 80 75 77 77 77 77 38 38 0 0 0 0 0 0 0 
0 0 0 0 0 0 0 38 38 38 38 77 77 77 77 80 80 80 75 80 80 80 80 80 80 80 80 80 52 53 54 55 80 80 80 80 77 77 77 77 77 38 38 0 0 0 0 0 0 0 
0 0 0 0 0 0 0 38 38 38 38 77 77 77 77 77 80 80 80 80 80 80 80 80 80 80 80 75 56 57 58 59 80 80 77 77 77 77 77 77 77 38 38 0 0 0 0 0 0 0 
0 0 0 0 0 0 0 38 38 38 38 38 77 77 77 77 77 77 80 80 80 80 80 80 87 80 87 80 60 61 62 63 80 77 77 77 77 77 77 77 77 38 38 0 0 0 0 0 0 0 
0 0 0 0 0 0 0 38 38 38 38 38 38 38 38 77 77 77 77 77 80 80 80 80 88 80 88 80 80 80 80 75 77 77 77 77 77 77 77 77 38 38 38 0 0 0 0 0 0 0 
0 0 0 0 0 0 0 38 38 38 38 38 38 38 38 38 77 77 77 77 77 77 77 77 77 80 77 77 77 77 77 77 77 77 77 77 77 77 77 38 38 38 38 0 0 0 0 0 0 0 
0 0 0 0 0 0 0 38 39 39 38 38 38 38 38 38 38 38 77 69 77 77 77 77 77 80 77 77 77 77 77 77 77 77 77 77 77 38 38 38 38 38 38 0 0 0 0 0 0 0 
0 0 0 0 0 0 0 38 38 38 38 38 38 38 38 38 38 38 38 38 77 69 69 77 77 80 77 77 77 77 77 38 38 38 38 38 38 38 38 38 38 38 39 0 0 0 0 0 0 0 
0 0 0 0 0 0 0 38 38 38 38 38 38 38 38 38 38 38 38 38 38 38 77 77 77 80 77 77 38 38 38 38 38 38 38 38 38 38 38 38 38 38 38 0 0 0 0 0 0 0 
0 0 0 0 0 0 0 38 38 38 39 39 38 38 38 38 38 38 38 38 38 38 77 69 77 80 77 77 38 38 38 38 38 38 38 38 38 38 39 38 38 38 38 0 0 0 0 0 0 0 
0 0 0 0 0 0 0 38 38 38 38 38 38 38 38 38 38 39 38 38 38 38 77 77 69 80 77 77 38 38 38 39 38 38 38 38 38 38 38 38 38 38 38 0 0 0 0 0 0 0 
0 0 0 0 0 0 0 38 38 38 38 38 38 38 38 38 38 38 38 38 38 38 77 77 77 80 77 77 38 38 38 38 38 38 38 38 38 38 38 38 38 38 38 0 0 0 0 0 0 0 
0 0 0 0 0 0 0 38 38 38 38 38 38 38 38 38 38 38 38 38 38 38 77 77 77 80 77 77 77 38 38 38 38 38 38 38 38 38 38 38 38 38 38 0 0 0 0 0 0 0 
0 0 0 0 0 0 0 38 38 38 38 38 38 38 38 38 38 38 38 38 38 38 77 77 77 80 80 77 77 77 77 77 38 38 38 38 39 39 38 38 38 38 38 0 0 0 0 0 0 0 
0 0 0 0 0 0 0 38 38 38 38 38 38 38 38 38 38 38 38 38 38 38 77 77 77 77 80 77 77 77 77 77 69 38 38 38 38 38 38 38 38 38 38 0 0 0 0 0 0 0 
0 0 0 0 0 0 0 38 38 38 38 38 38 38 38 38 38 38 38 38 38 38 77 77 77 77 80 87 80 80 80 65 77 77 38 38 38 38 38 38 38 38 38 0 0 0 0 0 0 0 
0 0 0 0 0 0 0 38 38 38 38 38 38 38 38 38 38 38 38 38 38 38 77 77 77 77 80 88 80 80 80 64 77 77 77 38 38 38 38 38 38 38 38 0 0 0 0 0 0 0 
0 0 0 0 0 0 0 38 38 38 38 39 38 38 38 38 38 38 38 38 38 38 38 77 77 77 80 80 80 80 80 80 77 77 77 38 38 38 38 38 38 38 38 0 0 0 0 0 0 0 
0 0 0 0 0 0 0 38 38 38 38 38 38 38 38 38 38 38 38 38 38 38 38 77 77 77 76 80 80 80 80 80 77 69 38 38 38 38 38 38 39 38 38 0 0 0 0 0 0 0 
0 0 0 0 0 0 0 38 38 38 38 38 38 38 38 38 39 38 38 38 38 38 38 38 77 77 77 77 77 77 77 77 77 77 38 38 38 38 38 38 38 38 38 0 0 0 0 0 0 0 
0 0 0 0 0 0 0 38 38 38 38 38 38 38 38 38 38 38 38 38 38 38 38 38 38 38 38 38 38 38 38 38 38 38 38 38 38 38 39 38 38 38 38 0 0 0 0 0 0 0 
0 0 0 0 0 0 0 0 0 0 0 0 0 0 0 0 0 0 0 0 0 0 0 0 0 0 0 0 0 0 0 0 0 0 0 0 0 0 0 0 0 0 0 0 0 0 0 0 0 0 
0 0 0 0 0 0 0 0 0 0 0 0 0 0 0 0 0 0 0 0 0 0 0 0 0 0 0 0 0 0 0 0 0 0 0 0 0 0 0 0 0 0 0 0 0 0 0 0 0 0 
0 0 0 0 0 0 0 0 0 0 0 0 0 0 0 0 0 0 0 0 0 0 0 0 0 0 0 0 0 0 0 0 0 0 0 0 0 0 0 0 0 0 0 0 0 0 0 0 0 0 
0 0 0 0 0 0 0 0 0 0 0 0 0 0 0 0 0 0 0 0 0 0 0 0 0 0 0 0 0 0 0 0 0 0 0 0 0 0 0 0 0 0 0 0 0 0 0 0 0 0 
0 0 0 0 0 0 0 0 0 0 0 0 0 0 0 0 0 0 0 0 0 0 0 0 0 0 0 0 0 0 0 0 0 0 0 0 0 0 0 0 0 0 0 0 0 0 0 0 0 0 
0 0 0 0 0 0 0 0 0 0 0 0 0 0 0 0 0 0 0 0 0 0 0 0 0 0 0 0 0 0 0 0 0 0 0 0 0 0 0 0 0 0 0 0 0 0 0 0 0 0 
