0 0 0 0 0 0 0 0 0 0 0 0 0 0 0 0 0 0 0 0 0 0 0 0 0 0 0 0 0 0 0 0 0 0 0 0 0 0 0 0 0 0 0 0 0 0 0 0 0 0 
0 0 0 0 0 0 0 0 0 0 0 0 0 0 0 0 0 0 0 0 0 0 0 0 0 0 0 0 0 0 0 0 0 0 0 0 0 0 0 0 0 0 0 0 0 0 0 0 0 0 
0 0 0 0 0 0 0 0 0 0 0 0 0 0 0 0 0 0 0 0 0 0 0 0 0 0 0 0 0 0 0 0 0 0 0 0 0 0 0 0 0 0 0 0 0 0 0 0 0 0 
0 0 0 0 0 0 0 77 77 77 77 77 77 77 77 77 77 77 77 77 77 77 77 77 77 77 77 77 77 77 77 73 77 77 77 77 77 77 77 77 77 77 77 0 0 0 0 0 0 0 
0 0 0 0 0 0 0 77 77 77 77 77 77 77 77 77 77 77 77 77 77 77 79 79 79 79 79 79 79 79 79 79 79 79 79 79 79 79 77 77 77 77 77 0 0 0 0 0 0 0 
0 0 0 0 0 0 0 77 77 77 77 77 77 77 77 77 77 77 77 77 77 77 84 84 84 84 84 84 84 72 84 84 84 84 80 80 80 72 77 77 77 77 77 0 0 0 0 0 0 0 
0 0 0 0 0 0 0 77 77 77 77 77 77 77 77 77 77 77 77 77 77 77 77 77 77 77 77 77 77 71 77 77 77 77 80 80 80 82 77 77 77 77 77 0 0 0 0 0 0 0 
0 0 0 0 0 0 0 77 36 79 77 77 77 77 77 77 77 77 77 77 77 77 77 77 77 77 77 77 77 71 77 77 77 67 80 80 80 82 77 77 77 69 77 0 0 0 0 0 0 0 
0 0 0 0 0 0 0 77 84 80 77 77 77 77 77 79 79 79 79 79 79 77 77 77 77 77 77 77 77 71 77 79 79 68 84 84 80 82 69 77 77 77 77 0 0 0 0 0 0 0 
0 0 0 0 0 0 0 77 77 80 79 77 77 77 79 80 80 80 80 80 80 79 77 77 77 77 77 77 77 71 77 80 80 84 77 77 80 82 77 77 77 77 77 0 0 0 0 0 0 0 
0 0 0 0 0 0 0 77 77 83 83 83 83 83 83 80 80 80 80 80 80 80 77 77 77 77 79 79 79 70 79 80 84 77 77 77 80 70 79 77 77 77 77 0 0 0 0 0 0 0 
0 0 0 0 0 0 0 77 77 78 78 78 78 78 78 83 83 83 80 83 83 83 77 77 77 80 80 80 80 80 84 84 77 77 77 77 80 80 80 69 77 77 77 0 0 0 0 0 0 0 
0 0 0 0 0 0 0 77 77 77 77 77 77 77 77 78 78 78 80 78 78 78 77 77 80 80 80 84 84 84 77 77 77 77 77 77 80 80 80 77 77 77 77 0 0 0 0 0 0 0 
0 0 0 0 0 0 0 77 77 77 77 77 77 77 77 77 77 77 80 77 77 77 77 80 80 84 84 77 77 77 77 77 77 77 77 77 80 80 80 79 77 77 77 0 0 0 0 0 0 0 
0 0 0 0 0 0 0 77 77 77 77 77 77 77 77 77 77 77 80 77 77 77 80 80 80 77 77 77 77 77 77 77 77 77 77 79 80 80 80 80 77 77 77 0 0 0 0 0 0 0 
0 0 0 0 0 0 0 77 77 77 77 77 77 77 77 79 79 79 80 79 77 77 80 84 84 77 77 79 77 77 77 77 77 73 77 80 80 80 80 80 79 77 77 0 0 0 0 0 0 0 
0 0 0 0 0 0 0 77 77 77 77 77 77 83 83 83 83 80 80 83 77 77 80 77 77 77 77 80 77 77 77 77 79 79 79 84 84 80 80 80 84 77 77 0 0 0 0 0 0 0 
0 0 0 0 0 0 0 77 79 79 77 77 77 78 78 78 78 80 80 78 77 77 80 77 77 79 79 80 79 79 77 77 80 84 84 77 77 84 80 84 77 77 77 0 0 0 0 0 0 0 
0 0 0 0 0 0 0 77 80 80 79 79 77 77 77 77 77 80 80 77 77 77 80 77 77 80 80 80 80 80 79 79 84 77 77 77 77 77 80 77 77 77 77 0 0 0 0 0 0 0 
0 0 0 0 0 0 0 77 80 87 80 80 79 77 77 77 77 80 80 77 77 77 80 77 77 84 80 80 80 80 84 84 77 77 77 77 77 77 80 77 77 77 77 0 0 0 0 0 0 0 
0 0 0 0 0 0 0 77 80 88 80 80 80 77 77 77 77 80 80 77 77 77 80 77 77 77 84 84 84 84 77 77 77 77 77 77 77 77 80 77 77 77 77 0 0 0 0 0 0 0 
0 0 0 0 0 0 0 77 84 84 80 84 84 77 77 77 77 80 80 77 79 79 80 79 77 77 77 77 77 77 77 77 77 77 77 77 77 77 80 77 77 77 77 0 0 0 0 0 0 0 
0 0 0 0 0 0 0 77 77 77 80 77 77 77 77 77 74 80 80 77 66 84 84 84 77 77 77 77 77 77 77 77 77 69 77 77 77 77 80 67 77 77 77 0 0 0 0 0 0 0 
0 0 0 0 0 0 0 77 77 77 80 77 77 77 77 77 77 80 80 77 65 77 77 77 77 77 77 77 77 77 77 77 77 77 77 69 77 79 80 68 79 77 77 0 0 0 0 0 0 0 
0 0 0 0 0 0 0 77 77 77 80 77 77 77 79 80 87 80 80 87 64 80 72 77 77 77 77 77 77 77 77 77 77 77 79 79 79 80 80 80 80 77 77 0 0 0 0 0 0 0 
0 0 0 0 0 0 0 77 77 77 80 77 77 79 80 80 88 80 80 88 80 80 82 77 77 77 77 77 77 77 77 77 79 79 80 80 87 80 80 80 87 77 77 0 0 0 0 0 0 0 
0 0 0 0 0 0 0 77 77 77 80 79 79 80 80 80 80 80 80 80 80 80 82 77 77 77 77 77 69 77 77 85 80 80 80 80 88 80 80 80 88 77 69 0 0 0 0 0 0 0 
0 0 0 0 0 0 0 77 77 77 83 83 83 83 80 80 80 80 80 80 80 80 82 77 77 73 77 77 77 77 77 86 80 80 80 80 80 83 83 80 80 77 77 0 0 0 0 0 0 0 
0 0 0 0 0 0 0 77 77 77 78 78 78 78 83 83 83 80 80 80 80 80 70 79 79 79 79 79 79 79 79 80 83 83 83 83 83 78 78 80 80 69 77 0 0 0 0 0 0 0 
0 0 0 0 0 0 0 77 77 77 77 77 77 77 78 78 78 80 80 78 78 78 78 78 78 78 80 78 78 78 78 78 78 78 78 78 78 77 77 80 80 77 77 0 0 0 0 0 0 0 
0 0 0 0 0 0 0 77 77 77 77 77 77 77 77 77 77 80 80 77 77 77 77 77 77 77 80 77 77 77 77 77 77 77 77 77 77 77 77 80 80 77 77 0 0 0 0 0 0 0 
0 0 0 0 0 0 0 77 77 77 77 77 77 77 77 77 69 80 80 73 77 77 77 77 69 77 80 77 77 77 69 77 77 77 77 77 77 77 77 84 84 77 77 0 0 0 0 0 0 0 
0 0 0 0 0 0 0 77 77 77 77 77 77 77 77 77 77 80 80 77 77 77 77 77 77 77 80 77 77 77 77 77 77 77 77 77 77 77 77 77 77 77 77 0 0 0 0 0 0 0 
0 0 0 0 0 0 0 77 77 77 77 69 77 77 77 77 77 80 80 77 77 69 77 77 77 79 80 79 77 77 77 77 77 69 77 77 69 77 77 77 77 77 77 0 0 0 0 0 0 0 
0 0 0 0 0 0 0 77 77 77 77 77 77 77 77 79 79 80 80 80 72 77 77 77 77 75 80 80 77 77 77 77 77 77 77 77 77 77 77 77 77 77 77 0 0 0 0 0 0 0 
0 0 0 0 0 0 0 77 69 77 73 77 69 77 77 87 80 80 80 87 82 77 77 77 77 78 78 78 77 77 77 77 69 77 77 77 69 77 77 77 77 77 77 0 0 0 0 0 0 0 
0 0 0 0 0 0 0 77 69 77 77 77 77 65 77 88 80 80 80 88 82 77 77 77 77 77 77 77 77 77 77 77 77 77 77 77 77 77 69 77 69 77 77 77 77 0 0 0 0 0 
0 0 0 0 0 0 0 77 77 79 79 79 79 64 79 80 52 53 53 55 82 77 69 77 77 77 77 77 77 77 77 77 85 77 69 77 79 79 79 79 79 79 71 77 77 0 0 0 0 0 
0 0 0 0 0 0 0 69 77 80 80 72 83 83 83 80 56 57 57 59 82 77 77 77 85 77 77 77 77 69 77 77 86 79 79 79 80 80 80 80 80 80 71 77 77 0 0 0 0 0 
0 0 0 0 0 0 0 77 77 80 80 82 78 78 78 80 60 61 62 80 70 79 79 79 86 79 79 79 79 79 79 79 80 80 80 80 80 72 84 84 80 80 71 77 77 0 0 0 0 0 
0 0 0 0 0 0 0 77 79 80 80 82 77 77 77 83 83 83 83 83 83 83 83 83 83 83 83 83 83 83 83 83 80 80 80 87 80 82 77 77 80 80 71 77 77 0 0 0 0 0 
0 0 0 0 0 0 0 77 76 80 80 82 77 77 77 78 78 78 78 78 78 78 78 78 78 78 78 78 78 78 78 78 83 83 80 88 80 82 69 77 83 83 71 77 77 0 0 0 0 0 
0 0 0 0 0 0 0 77 87 80 80 82 77 77 77 77 77 77 77 77 69 69 77 77 77 77 77 69 77 77 77 77 84 84 84 84 84 82 77 77 78 78 77 77 77 0 0 0 0 0 
0 0 0 0 0 0 0 77 88 80 80 70 77 77 77 77 77 77 77 77 77 69 77 77 77 77 77 77 77 77 69 77 77 77 77 77 77 77 77 77 77 77 77 77 77 0 0 0 0 0 
0 0 0 0 0 0 0 77 78 78 78 78 77 77 0 0 0 0 0 0 0 0 0 0 0 0 0 0 0 0 0 0 0 0 0 0 0 0 0 0 0 0 0 0 0 0 0 0 0 0 
0 0 0 0 0 0 0 0 0 0 0 0 0 0 0 0 0 0 0 0 0 0 0 0 0 0 0 0 0 0 0 0 0 0 0 0 0 0 0 0 0 0 0 0 0 0 0 0 0 0 
0 0 0 0 0 0 0 0 0 0 0 0 0 0 0 0 0 0 0 0 0 0 0 0 0 0 0 0 0 0 0 0 0 0 0 0 0 0 0 0 0 0 0 0 0 0 0 0 0 0 
0 0 0 0 0 0 0 0 0 0 0 0 0 0 0 0 0 0 0 0 0 0 0 0 0 0 0 0 0 0 0 0 0 0 0 0 0 0 0 0 0 0 0 0 0 0 0 0 0 0 
0 0 0 0 0 0 0 0 0 0 0 0 0 0 0 0 0 0 0 0 0 0 0 0 0 0 0 0 0 0 0 0 0 0 0 0 0 0 0 0 0 0 0 0 0 0 0 0 0 0 
0 0 0 0 0 0 0 0 0 0 0 0 0 0 0 0 0 0 0 0 0 0 0 0 0 0 0 0 0 0 0 0 0 0 0 0 0 0 0 0 0 0 0 0 0 0 0 0 0 0 
